...............
...............
F......F....X..
--.....O....L..
.....----......
.....-......---
.S.K......F.-..
-------------..