...............
X..F.........F.
----........---
.......FP......
......---......
...............
S...D..F......E
---------------