...............
F.....F......F.
---..---....L..
...........K...
.....BX....----
.....----......
S.O..-..-D....E
------..-------
