...............
...D..F.E......
...-----....F..
X..........----
--......F..BBB.
....F..L.......
D.........E.S..
---------------