...............
S.F.........F..
---...F....----
.....----.B....
F..............
L.....F........
..B...O....X...
---------------